Affenpinscher	Toy
Silky Terrier	Toy
Cavalier King Charles Spaniel	Toy
Cavalier Spaniel	Toy
Chihuahua Longhair	Toy
Chihuahua Shorthair	Toy
Chinese Crested	Toy
Manchester Terrier	Toy
Brussels Griffon	Toy
Havanese	Toy
Italian Greyhound	Toy
Japanese Chin	Toy
English Toy Spaniel	Toy
Maltese	Toy
Miniature Pinscher	Toy
Papillon	Toy
Pekingese	Toy
Pomeranian	Toy
Toy Fox Terrier	Toy
Toy Poodle	Toy
Miniature Poodle	Toy
Pug	Toy
Shih Tzu	Toy
Yorkshire Terrier	Toy
Affenpinscher Mix	Toy Mix
Silky Terrier Mix	Toy Mix
Cavalier King Charles Spaniel Mix	Toy Mix
Cavalier Spaniel Mix	Toy Mix
Chihuahua Longhair Mix	Toy Mix
Chihuahua Shorthair Mix	Toy Mix
Chinese Crested Mix	Toy Mix
Manchester Terrier Mix	Toy Mix
Brussels Griffon Mix	Toy Mix
Havanese Mix	Toy Mix
Italian Greyhound Mix	Toy Mix
Japanese Chin Mix	Toy Mix
English Toy Spaniel Mix	Toy Mix
Maltese Mix	Toy Mix
Miniature Pinscher Mix	Toy Mix
Papillon Mix	Toy Mix
Pekingese Mix	Toy Mix
Pomeranian Mix	Toy Mix
Toy Fox Terrier Mix	Toy Mix
Toy Poodle Mix	Toy Mix
Miniature Poodle Mix	Toy Mix
Pug Mix	Toy Mix
Shih Tzu Mix	Toy Mix
Yorkshire Terrier Mix	Toy Mix