Australian Kelpie	Foundation Stock Service
Carolina Dog	Foundation Stock Service
Catahoula	Foundation Stock Service
Treeing Tennesse Brindle	Foundation Stock Service
Treeing Cur	Foundation Stock Service
Hovawart	Foundation Stock Service
Jindo	Foundation Stock Service
Presa Canario	Foundation Stock Service
Spanish Mastiff	Foundation Stock Service
Australian Kelpie Mix	Foundation Stock Service
Carolina Dog Mix	Foundation Stock Service
Catahoula Mix	Foundation Stock Service
Treeing Tennesse Brindle Mix	Foundation Stock Service
Treeing Cur Mix	Foundation Stock Service
Hovawart Mix	Foundation Stock Service
Jindo Mix	Foundation Stock Service
Presa Canario Mix	Foundation Stock Service
Spanish Mastiff Mix	Foundation Stock Service
Australian Cattle Dog	Herding
Australian Shepherd	Herding
Bearded Collie	Herding
Beauceron	Herding
Belgian Malinois	Herding
Belgian Sheepdog	Herding
Belgian Tervuren	Herding
Bergamasco	Herding
Berger Picard	Herding
Border Collie	Herding
Bouvier des Flandres	Herding
Briard	Herding
Canaan Dog	Herding
Cardigan Welsh Corgi	Herding
Collie	Herding
Collie Rough	Herding
Collie Smooth	Herding
Entlebucher Mountain Dog	Herding
Entlebucher	Herding
Finnish Lapphund	Herding
German Shepherd	Herding
Icelandic Sheepdog	Herding
Miniature American Shepherd	Herding
Norwegian Buhund	Herding
Old English Sheepdog	Herding
Pembroke Welsh Corgi	Herding
Picardy Sheepdog	Herding
Polish Lowland Sheepdog	Herding
Puli	Herding
Pyrenean Shepherd	Herding
Queensland Heeler	Herding
Shetland Sheepdog	Herding
Spanish Water Dog	Herding
Swedish Vallhund	Herding
Australian Cattle Dog Mix	Herding
Australian Shepherd Mix	Herding
Bearded Collie Mix	Herding
Beauceron Mix	Herding
Belgian Malinois Mix	Herding
Belgian Sheepdog Mix	Herding
Belgian Tervuren Mix	Herding
Bergamasco Mix	Herding
Berger Picard Mix	Herding
Border Collie Mix	Herding
Bouvier des Flandres Mix	Herding
Briard	Herding
Canaan Dog Mix	Herding
Cardigan Welsh Corgi Mix	Herding
Collie Mix	Herding
Collie Rough Mix	Herding
Collie Smooth Mix	Herding
Entlebucher Mountain Dog Mix	Herding
Entlebucher Mix	Herding
Finnish Lapphund Mix	Herding
German Shepherd Mix	Herding
Icelandic Sheepdog Mix	Herding
Miniature American Shepherd Mix	Herding
Norwegian Buhund Mix	Herding
Old English Sheepdog Mix	Herding
Pembroke Welsh Corgi Mix	Herding
Picardy Sheepdog Mix	Herding
Polish Lowland Sheepdog Mix	Herding
Puli Mix	Herding
Pyrenean Shepherd Mix	Herding
Queensland Heeler Mix	Herding
Shetland Sheepdog Mix	Herding
Spanish Water Dog Mix	Herding
Swedish Vallhund Mix	Herding
Afghan Hound	Hound
Africanis	Hound
American Foxhound	Hound
American Leopard Hound	Hound
Andalusian Hound	Hound
Artois Hound	Hound
Austrian Black and Tan Hound	Hound
Azawakh	Hound
Basenji	Hound
Basset Artesien Normand	Hound
Basset Bleu de Gascogne	Hound
Basset Fauve de Bretagne	Hound
Grand Basset Griffon Vendeen	Hound
Petit Basset Griffon Vendeen	Hound
Basset Hound	Hound
Bavarian Mountain Hound	Hound
Beagle	Hound
Beagle-Harrier	Hound
Black and Tan Coonhound	Hound
Black and Tan Virginia Foxhound	Hound
Blackmouth Cur	Hound
Bloodhound	Hound
Bluetick Coonhound	Hound
Bluetick Hound	Hound
Borzoi	Hound
Bosnian Coarse-haired Hound	Hound
Chippiparai	Hound
Cirneco dell'Etna	Hound
Combai	Hound
Coonhound	Hound
Cretan Hound	Hound
Dachshund	Hound
Dachshund Longhair	Hound
Dachshund Wirehair	Hound
Deerhound	Hound
Dumfriesshire Hound	Hound
English Coonhound	Hound
Estonian Hound	Hound
English Foxhound	Hound
Finnish Hound	Hound
Foxhound	Hound
Grand Bleu de Gascogne	Hound
Greek Harehound	Hound
Greyhound	Hound
Hamiltonstovare	Hound
Harrier	Hound
Ibizan Hound	Hound
Indian Pariah Dog	Hound
Italian Greyhound	Hound
Irish Wolfhound	Hound
Istrian Coarse-haired Hound	Hound
Istrian Shorthaired Hound	Hound
Jämthund	Hound
Kanni	Hound
Kelb tal-Fenek	Hound
Lithuanian Hound	Hound
Mudhol hound	Hound
Norwegian Elkhound	Hound
Otterhound	Hound
Pbgv	Hound
Pharaoh Hound	Hound
Piccolo Lepraiolo Italiano	Hound
Plott Hound	Hound
Podengo Pequeno	Hound
Polish Hound	Hound
Portuguese Podengo	Hound
Posavac Hound	Hound
Rajapalayam	Hound
Redbone Coonhound	Hound
Redbone Hound	Hound
Rhodesian Ridgeback	Hound
Sabueso Español	Hound
Saluki	Hound
Segugio Italiano a Pelo Forte	Hound
Segugio Italiano a Pelo Raso	Hound
Segugio Maremmano	Hound
Serbian Hound	Hound
Serbian Tricolour Hound	Hound
Schweizer Laufhund	Hound
Scottish Deerhound	Hound
Silken Windhound	Hound
Sloughi	Hound
Taigan	Hound
Thai Ridgeback	Hound
Treeing Walker Coonhound	Hound
Trigg Hound	Hound
Transylvanian Hound	Hound
Whippet	Hound
Afghan Hound Mix	Hound
Africanis Mix	Hound
American Foxhound Mix	Hound
American Leopard Hound Mix	Hound
Andalusian Hound Mix	Hound
Artois Hound Mix	Hound
Austrian Black and Tan Hound Mix	Hound
Azawakh Mix	Hound
Basenji Mix	Hound
Basset Artesien Normand Mix	Hound
Basset Bleu de Gascogne Mix	Hound
Basset Fauve de Bretagne Mix	Hound
Grand Basset Griffon Vendeen Mix	Hound
Petit Basset Griffon Vendeen Mix	Hound
Basset Hound Mix	Hound
Bavarian Mountain Hound Mix	Hound
Beagle Mix	Hound
Beagle-Harrier Mix	Hound
Black and Tan CoonHound Mix	Hound
Black and Tan Virginia FoxHound Mix	Hound
Blackmouth Cur Mix	Hound
BloodHound Mix	Hound
Bluetick CoonHound Mix	Hound
Bluetick Hound Mix	Hound
Borzoi Mix	Hound
Bosnian Coarse-haired Hound Mix	Hound
Chippiparai Mix	Hound
Cirneco dell’Etna Mix	Hound
Combai Mix	Hound
CoonHound	Hound
Cretan Hound Mix	Hound
Dachshund Mix	Hound
Dachshund Longhair Mix	Hound
Dachshund Wirehair Mix	Hound
DeerHound Mix	Hound
Dumfriesshire Hound Mix	Hound
English CoonHound Mix	Hound
Estonian Hound Mix	Hound
English FoxHound Mix	Hound
Finnish Hound Mix	Hound
FoxHound Mix	Hound
Grand Bleu de Gascogne Mix	Hound
Greek HareHound Mix	Hound
GreyHound Mix	Hound
Hamiltonstovare Mix	Hound
Harrier Mix	Hound
Ibizan Hound Mix	Hound
Indian Pariah Dog Mix	Hound
Italian GreyHound Mix	Hound
Irish WolfHound Mix	Hound
Istrian Coarse-haired Hound Mix	Hound
Istrian Shorthaired Hound Mix	Hound
Jämthund Mix	Hound
Kanni Mix	Hound
Kelb tal-Fenek Mix	Hound
Lithuanian Hound Mix	Hound
Mudhol Hound Mix	Hound
Norwegian ElkHound Mix	Hound
OtterHound Mix	Hound
Pbgv Mix	Hound
Pharaoh Hound Mix	Hound
Piccolo Lepraiolo Italiano Mix	Hound
Plott Hound Mix	Hound
Podengo Pequeno Mix	Hound
Polish Hound Mix	Hound
Portuguese Podengo Mix	Hound
Posavac Hound Mix	Hound
Rajapalayam Mix	Hound
Redbone CoonHound Mix	Hound
Redbone Hound Mix	Hound
Rhodesian Ridgeback Mix	Hound
Sabueso Español Mix	Hound
Saluki Mix	Hound
Segugio Italiano a Pelo Forte Mix	Hound
Segugio Italiano a Pelo Raso Mix	Hound
Segugio Maremmano Mix	Hound
Serbian Hound Mix	Hound
Serbian Tricolour Hound	Hound
Schweizer Laufhund Mix	Hound
Scottish DeerHound Mix	Hound
Silken WindHound Mix	Hound
Sloughi Mix	Hound
Taigan Mix	Hound
Thai Ridgeback Mix	Hound
Treeing Walker CoonHound Mix	Hound
Trigg Hound Mix	Hound
Transylvanian Hound	Hound
Whippet Mix	Hound
Azawakh	Miscellaneous
Belgian Laekenois	Miscellaneous
Dogo Argentino	Miscellaneous
Dutch Shepherd	Miscellaneous
Grand Basset Griffon Vendéen	Miscellaneous
Nederlandse Kooikerhondje	Miscellaneous
Norrbottenspets	Miscellaneous
Peruvian Inca Orchid	Miscellaneous
Portuguese Podengo Grande	Miscellaneous
Portuguese Podengo Medio	Miscellaneous
Pumi	Miscellaneous
Azawakh Mix	Miscellaneous
Belgian Laekenois Mix	Miscellaneous
Dogo Argentino Mix	Miscellaneous
Dutch Shepherd Mix	Miscellaneous
Grand Basset Griffon Vendéen Mix	Miscellaneous
Nederlandse Kooikerhondje Mix	Miscellaneous
Norrbottenspets Mix	Miscellaneous
Peruvian Inca Orchid Mix	Miscellaneous
Portuguese Podengo Grande Mix	Miscellaneous
Portuguese Podengo Medio Mix	Miscellaneous
Pumi Mix	Miscellaneous
American Eskimo	Non-Sporting
Bichon Frise	Non-Sporting
Boston Terrier	Non-Sporting
Bulldog	Non-Sporting
Chinese Sharpei	Non-Sporting
Chow Chow	Non-Sporting
Coton De Tulear	Non-Sporting
Dalmatian	Non-Sporting
English Bulldog	Non-Sporting
Finnish Spitz	Non-Sporting
French Bulldog	Non-Sporting
Keeshond	Non-Sporting
Lhasa Apso	Non-Sporting
Lowchen	Non-Sporting
Mexican Hairless	Non-Sporting
Poodle	Non-Sporting
Schipperke	Non-Sporting
Shiba Inu	Non-Sporting
Standard Poodle	Non-Sporting
Tibetan Spaniel	Non-Sporting
Tibetan Terrier	Non-Sporting
Xoloitzcuintli (Mexican Hairless Dog)	Non-Sporting
American Eskimo Mix	Non-Sporting
Bichon Frise Mix	Non-Sporting
Boston Terrier Mix	Non-Sporting
Bulldog Mix	Non-Sporting
Chinese Sharpei Mix	Non-Sporting
Chow Chow Mix	Non-Sporting
Coton De Tulear Mix	Non-Sporting
Dalmatian Mix	Non-Sporting
English Bulldog Mix	Non-Sporting
Finnish Spitz Mix	Non-Sporting
French Bulldog Mix	Non-Sporting
Keeshond Mix	Non-Sporting
Lhasa Apso Mix	Non-Sporting
Lowchen Mix	Non-Sporting
Mexican Hairless Mix	Non-Sporting
Poodle Mix	Non-Sporting
Schipperke Mix	Non-Sporting
Shiba Inu Mix	Non-Sporting
Standard Poodle Mix	Non-Sporting
Tibetan Spaniel Mix	Non-Sporting
Tibetan Terrier Mix	Non-Sporting
Xoloitzcuintli (Mexican Hairless Dog) Mix	Non-Sporting
American Water Spaniel	Sporting
American Cocker Spaniel	Sporting
Boykin Spaniel	Sporting
Brittany	Sporting
Chesapeake Bay Retriever	Sporting
Clumber Spaniel	Sporting
Cocker Spaniel	Sporting
Curly Coated Retriever	Sporting
English Cocker Spaniel	Sporting
English Pointer	Sporting
English Setter	Sporting
English Springer Spaniel	Sporting
Field Spaniel	Sporting
Flat Coat Retriever	Sporting
German Shorthair Pointer	Sporting
German Wirehaired Pointer	Sporting
Golden Retriever	Sporting
Gordon Setter	Sporting
Irish Setter	Sporting
Irish Water Spaniel	Sporting
Labrador Retriever	Sporting
Lagotto Romagnolo	Sporting
Nova Scotia Duck Tolling Retriever	Sporting
Pointer	Sporting
Spinone Italiano	Sporting
Sussex Spaniel	Sporting
Vizsla	Sporting
Weimaraner	Sporting
Welsh Springer Spaniel	Sporting
Wirehaired Pointing Griffon	Sporting
Wirehaired Vizsla	Sporting
American Water Spaniel Mix	Sporting
American Cocker Spaniel Mix	Sporting
Boykin Spaniel Mix	Sporting
Brittany Mix	Sporting
Chesapeake Bay Retriever Mix	Sporting
Clumber Spaniel Mix	Sporting
Cocker Spaniel Mix	Sporting
Curly Coated Retriever Mix	Sporting
English Cocker Spaniel Mix	Sporting
English Pointer Mix	Sporting
English Setter Mix	Sporting
English Springer Spaniel Mix	Sporting
Field Spaniel Mix	Sporting
Flat Coat Retriever Mix	Sporting
German Shorthair Pointer Mix	Sporting
German Wirehaired Pointer Mix	Sporting
Golden Retriever Mix	Sporting
Gordon Setter Mix	Sporting
Irish Setter Mix	Sporting
Irish Water Spaniel Mix	Sporting
Labrador Retriever Mix	Sporting
Lagotto Romagnolo Mix	Sporting
Nova Scotia Duck Tolling Retriever Mix	Sporting
Pointer Mix	Sporting
Spinone Italiano Mix	Sporting
Sussex Spaniel Mix	Sporting
Vizsla Mix	Sporting
Weimaraner Mix	Sporting
Welsh Springer Spaniel Mix	Sporting
Wirehaired Pointing Griffon Mix	Sporting
Wirehaired Vizsla Mix	Sporting
Airedale Terrier	Terrier
American Staffordshire Terrier	Terrier
Australian Terrier	Terrier
Bedlington Terrier	Terrier
Border Terrier	Terrier
Bull Terrier Miniature	Terrier
Bull Terrier	Terrier
Cairn Terrier	Terrier
Cesky Terrier	Terrier
Dandie Dinmont	Terrier
Dandie Dinmont Terrier	Terrier
Feist	Terrier
Glen of Imaal Terrier	Terrier
Glen of Imaal	Terrier
Irish Terrier	Terrier
Kerry Blue Terrier	Terrier
Lakeland Terrier	Terrier
Manchester Terrier	Terrier
Miniature Bull Terrier	Terrier
Miniature Schnauzer	Terrier
Norfolk Terrier	Terrier
Norwich Terrier	Terrier
Parson Russell Terrier	Terrier
Rat Terrier	Terrier
Russell Terrier	Terrier
Scottish Terrier	Terrier
Sealyham Terrier	Terrier
Skye Terrier	Terrier
Smooth Fox Terrier	Terrier
Soft Coated Wheaten Terrier	Terrier
Staffordshire Bull Terrier	Terrier
Staffordshire	Terrier
Welsh Terrier	Terrier
West Highland	Terrier
West Highland White Terrier	Terrier
Wire Hair Fox Terrier	Terrier
Airedale Terrier Mix	Terrier
American Staffordshire Terrier Mix	Terrier
Australian Terrier Mix	Terrier
Bedlington Terrier Mix	Terrier
Border Terrier Mix	Terrier
Bull Terrier Miniature Mix	Terrier
Bull Terrier Mix	Terrier
Cairn Terrier Mix	Terrier
Cesky Terrier Mix	Terrier
Dandie Dinmont Mix	Terrier
Dandie Dinmont Terrier Mix	Terrier
Feist Mix	Terrier
Glen of Imaal Terrier Mix	Terrier
Glen of Imaal Mix	Terrier
Irish Terrier Mix	Terrier
Kerry Blue Terrier Mix	Terrier
Lakeland Terrier Mix	Terrier
Manchester Terrier Mix	Terrier
Miniature Bull Terrier Mix	Terrier
Miniature Schnauzer Mix	Terrier
Norfolk Terrier Mix	Terrier
Norwich Terrier Mix	Terrier
Parson Russell Terrier Mix	Terrier
Rat Terrier Mix	Terrier
Russell Terrier Mix	Terrier
Scottish Terrier Mix	Terrier
Sealyham Terrier Mix	Terrier
Skye Terrier Mix	Terrier
Smooth Fox Terrier Mix	Terrier
Soft Coated Wheaten Terrier Mix	Terrier
Staffordshire Bull Terrier Mix	Terrier
Staffordshire Mix	Terrier
Welsh Terrier Mix	Terrier
West Highland Mix	Terrier
West Highland White Terrier Mix	Terrier
Wire Hair Fox Terrier Mix	Terrier
Affenpinscher	Toy
Silky Terrier	Toy
Cavalier King Charles Spaniel	Toy
Cavalier Spaniel	Toy
Chihuahua Longhair	Toy
Chihuahua Shorthair	Toy
Chinese Crested	Toy
Manchester Terrier	Toy
Brussels Griffon	Toy
Havanese	Toy
Italian Greyhound	Toy
Japanese Chin	Toy
English Toy Spaniel	Toy
Maltese	Toy
Miniature Pinscher	Toy
Papillon	Toy
Pekingese	Toy
Pomeranian	Toy
Toy Fox Terrier	Toy
Toy Poodle	Toy
Miniature Poodle	Toy
Pug	Toy
Shih Tzu	Toy
Yorkshire Terrier	Toy
Affenpinscher Mix	Toy
Silky Terrier Mix	Toy
Cavalier King Charles Spaniel Mix	Toy
Cavalier Spaniel Mix	Toy
Chihuahua Longhair Mix	Toy
Chihuahua Shorthair Mix	Toy
Chinese Crested Mix	Toy
Manchester Terrier Mix	Toy
Brussels Griffon Mix	Toy
Havanese Mix	Toy
Italian Greyhound Mix	Toy
Japanese Chin Mix	Toy
English Toy Spaniel Mix	Toy
Maltese Mix	Toy
Miniature Pinscher Mix	Toy
Papillon Mix	Toy
Pekingese Mix	Toy
Pomeranian Mix	Toy
Toy Fox Terrier Mix	Toy
Toy Poodle Mix	Toy
Miniature Poodle Mix	Toy
Pug Mix	Toy
Shih Tzu Mix	Toy
Yorkshire Terrier Mix	Toy
Akita	Working
Alaskan Malamute	Working
Anatolian Shepherd	Working
Bernese Mountain Dog	Working
Black Russian Terrier	Working
Boerboel	Working
Boxer	Working
Bullmastiff	Working
Cane Corso	Working
Chinook	Working
Doberman Pinscher	Working
Dogue De Bordeaux	Working
German Pinscher	Working
Giant Schnauzer	Working
Great Dane	Working
Great Pyrenees	Working
Greater Swiss Mountain Dog	Working
Komondor	Working
Kuvasz	Working
Leonberger	Working
Mastiff	Working
Neapolitan Mastiff	Working
Newfoundland	Working
Port Water Dog	Working
Portuguese Water Dog	Working
Rottweiler	Working
Schnauzer Giant	Working
St. Bernard	Working
St. Bernard Rough Coat	Working
St. Bernard Smooth Coat	Working
Samoyed	Working
Siberian Husky	Working
Standard Schnauzer	Working
Tibetan Mastiff	Working
Akita Mix	Working
Alaskan Malamute Mix	Working
Anatolian Shepherd Mix	Working
Bernese Mountain Dog Mix	Working
Black Russian Terrier Mix	Working
Boerboel Mix	Working
Boxer Mix	Working
Bullmastiff Mix	Working
Cane Corso Mix	Working
Chinook Mix	Working
Doberman Pinscher Mix	Working
Dogue De Bordeaux Mix	Working
German Pinscher Mix	Working
Giant Schnauzer Mix	Working
Great Dane Mix	Working
Great Pyrenees Mix	Working
Greater Swiss Mountain Dog Mix	Working
Komondor Mix	Working
Kuvasz Mix	Working
Leonberger Mix	Working
Mastiff Mix	Working
Neapolitan Mastiff Mix	Working
Newfoundland Mix	Working
Port Water Dog Mix	Working
Portuguese Water Dog Mix	Working
Rottweiler Mix	Working
Schnauzer Giant Mix	Working
St. Bernard Mix	Working
St. Bernard Rough Coat Mix	Working
St. Bernard Smooth Coat Mix	Working
Samoyed Mix	Working
Siberian Husky Mix	Working
Standard Schnauzer Mix	Working
Tibetan Mastiff Mix	Working