Azawakh	Miscellaneous
Belgian Laekenois	Miscellaneous
Dogo Argentino	Miscellaneous
Dutch Shepherd	Miscellaneous
Grand Basset Griffon Vendéen	Miscellaneous
Nederlandse Kooikerhondje	Miscellaneous
Norrbottenspets	Miscellaneous
Peruvian Inca Orchid	Miscellaneous
Portuguese Podengo Grande	Miscellaneous
Portuguese Podengo Medio	Miscellaneous
Pumi	Miscellaneous
Azawakh Mix	Miscellaneous Mix
Belgian Laekenois Mix	Miscellaneous Mix
Dogo Argentino Mix	Miscellaneous Mix
Dutch Shepherd Mix	Miscellaneous Mix
Grand Basset Griffon Vendéen Mix	Miscellaneous Mix
Nederlandse Kooikerhondje Mix	Miscellaneous Mix
Norrbottenspets Mix	Miscellaneous Mix
Peruvian Inca Orchid Mix	Miscellaneous Mix
Portuguese Podengo Grande Mix	Miscellaneous Mix
Portuguese Podengo Medio Mix	Miscellaneous Mix
Pumi Mix	Miscellaneous Mix