Airedale Terrier	Terrier
American Staffordshire Terrier	Terrier
Australian Terrier	Terrier
Bedlington Terrier	Terrier
Border Terrier	Terrier
Bull Terrier Miniature	Terrier
Bull Terrier	Terrier
Cairn Terrier	Terrier
Cesky Terrier	Terrier
Dandie Dinmont	Terrier
Dandie Dinmont Terrier	Terrier
Feist	Terrier
Glen of Imaal Terrier	Terrier
Glen of Imaal	Terrier
Irish Terrier	Terrier
Kerry Blue Terrier	Terrier
Lakeland Terrier	Terrier
Manchester Terrier	Terrier
Miniature Bull Terrier	Terrier
Miniature Schnauzer	Terrier
Norfolk Terrier	Terrier
Norwich Terrier	Terrier
Parson Russell Terrier	Terrier
Rat Terrier	Terrier
Russell Terrier	Terrier
Scottish Terrier	Terrier
Sealyham Terrier	Terrier
Skye Terrier	Terrier
Smooth Fox Terrier	Terrier
Soft Coated Wheaten Terrier	Terrier
Staffordshire Bull Terrier	Terrier
Staffordshire	Terrier
Welsh Terrier	Terrier
West Highland	Terrier
West Highland White Terrier	Terrier
Wire Hair Fox Terrier	Terrier
Airedale Terrier Mix	Terrier Mix
American Staffordshire Terrier Mix	Terrier Mix
Australian Terrier Mix	Terrier Mix
Bedlington Terrier Mix	Terrier Mix
Border Terrier Mix	Terrier Mix
Bull Terrier Miniature Mix	Terrier Mix
Bull Terrier Mix	Terrier Mix
Cairn Terrier Mix	Terrier Mix
Cesky Terrier Mix	Terrier Mix
Dandie Dinmont Mix	Terrier Mix
Dandie Dinmont Terrier Mix	Terrier Mix
Feist Mix	Terrier Mix
Glen of Imaal Terrier Mix	Terrier Mix
Glen of Imaal Mix	Terrier Mix
Irish Terrier Mix	Terrier Mix
Kerry Blue Terrier Mix	Terrier Mix
Lakeland Terrier Mix	Terrier Mix
Manchester Terrier Mix	Terrier Mix
Miniature Bull Terrier Mix	Terrier Mix
Miniature Schnauzer Mix	Terrier Mix
Norfolk Terrier Mix	Terrier Mix
Norwich Terrier Mix	Terrier Mix
Parson Russell Terrier Mix	Terrier Mix
Rat Terrier Mix	Terrier Mix
Russell Terrier Mix	Terrier Mix
Scottish Terrier Mix	Terrier Mix
Sealyham Terrier Mix	Terrier Mix
Skye Terrier Mix	Terrier Mix
Smooth Fox Terrier Mix	Terrier Mix
Soft Coated Wheaten Terrier Mix	Terrier Mix
Staffordshire Bull Terrier Mix	Terrier Mix
Staffordshire Mix	Terrier Mix
Welsh Terrier Mix	Terrier Mix
West Highland Mix	Terrier Mix
West Highland White Terrier Mix	Terrier Mix
Wire Hair Fox Terrier Mix	Terrier Mix